level,1;|R,R,R,R,R,R,R,R,R,R,R,;
R,g,30,g,g,g,g,g,g,g,R,;
R,g,d,g,g,g,g,30,g,g,R,;
R,g,g,d,g,g,d,g,g,g,R,;
R,g,d,g,g,d,g,g,g,g,R,;
R,d,d,d,d,g,g,g,g,g,R,;
R,g,d,X,d,d,g,g,g,g,R,;
R,g,g,g,g,g,g,g,g,g,R,;
R,g,g,g,g,g,g,g,g,g,R,;
R,g,g,g,g,g,g,g,g,g,R,;
R,g,g,g,g,g,g,g,g,g,R,;
R,g,g,g,g,g,g,g,g,g,R,;
R,R,R,R,R,R,R,R,R,R,R,;
