R,R,R,R,R,R,R,R,R,R,R,R,R,R,;
R, ,W, , , , ,t, , ,t, , ,R,;
R, , , , , ,O, , , , , , ,R,;
R, , , , , , ,S, , , , , ,R,;
R, , , ,t, ,S, , , , , , ,R,;
R, , ,t, , ,F, ,O, , , , ,R,;
R, , , , , , ,W, ,G, , , ,R,;
R, , , , , , , , ,G, , , ,R,;
R, , , , , , , , , , , ,S,R,;
R, , , , , , ,F, ,g, , , ,R,;
R, , , ,W, , , , , ,C, , ,R,;
R, ,t,F,g, , , , , ,t, , ,R,;
R, , ,S, , , , , , , , , ,R,;
R,R,R,R,R,R,R,R,R,R,R,R,R,R,;
