level,1;|R,R,R,R,R,R,R,R,R,R,R,;
R,g,g,g,g,g,g,g,g,g,R,;
R,g,g,g,g,g,g,g,g,g,R,;
R,g,g,d,d,g,g,g,g,g,R,;
R,g,d,g,g,g,g,g,g,g,R,;
R,d,X,g,g,g,g,g,g,g,R,;
R,g,d,g,g,g,g,g,g,g,R,;
R,g,g,d,g,g,g,g,g,g,R,;
R,g,g,g,d,g,g,g,g,g,R,;
R,g,g,g,g,d,d,26,g,g,R,;
R,g,g,g,g,g,g,g,g,g,R,;
R,g,g,g,g,g,g,g,g,g,R,;
R,R,R,R,R,R,R,R,R,R,R,;
