R,R,R,R,R,R,R,R,R,R,R,;
R, , , , , , , , , ,R,;
R, , ,G, , , , , ,S,R,;
R, , , , , , ,g, ,F,R,;
R, , , , , , , , , ,R,;
R, , , , , , , , ,O,R,;
R, , ,F, , , , , , ,R,;
R, , , , , , , , , ,R,;
R, , , , , , ,C, ,g,R,;
R,F, , , , , , , , ,R,;
R, , , ,G, , , , ,G,R,;
R, , ,t,W, ,S, , , ,R,;
R,t, , , , , ,G, , ,R,;
R, ,O, , , , , , , ,R,;
R,R,R,R,R,R,R,R,R,R,R,;
