R,R,R,R,R,R,R,R,R,R,R,;
R, , , ,C, , , , ,t,R,;
R, , ,g,g, , , , , ,R,;
R, , , , , , , , ,W,R,;
R, , , ,t, , , , , ,R,;
R, , , , , , ,t, , ,R,;
R, ,W, , , , ,g, , ,R,;
R, , , , , , , , ,g,R,;
R, , , , , , , , ,g,R,;
R,t, , , , ,g, , , ,R,;
R, , ,G, , , , , , ,R,;
R,t, ,t, , , , , , ,R,;
R,R,R,R,R,R,R,R,R,R,R,;
