music,music_Hellish;
|
R,R,R,R,R,R,R,R;
R,d,d,g,g,g,g,R;
R,g,d,d,g,g,g,R;
R,g,g,d,g,g,g,R;
R,g,g,d,d,g,g,R;
R,g,g,d,d,g,g,R;
R,g,g,g,d,d,2,R;
R,R,R,R,R,R,R,R;