level,6;|R,R,R,R,R,R,R,R,R,R,R,R,R,R,;
R,g,g,g,g,g,g,g,g,g,g,g,g,R,;
R,g,g,g,g,g,g,g,g,g,g,g,g,R,;
R,g,g,g,g,g,g,g,g,g,g,g,g,R,;
R,g,g,g,g,g,g,g,g,g,g,g,g,R,;
R,g,g,g,g,g,g,d,98,g,g,g,g,R,;
R,g,g,d,g,g,d,g,g,g,g,g,g,R,;
R,g,g,d,g,d,d,g,d,g,f,g,g,R,;
R,g,g,d,d,g,g,d,g,d,g,g,g,R,;
R,g,g,d,d,d,d,d,g,99,g,g,g,R,;
R,X,d,d,g,g,d,d,98,g,g,g,g,R,;
R,g,g,g,g,g,g,g,g,g,g,g,g,R,;
R,R,R,R,R,R,R,R,R,R,R,R,R,R,;
