level,7;|R,R,R,R,R,R,R,R,R,R,R,;
R,g,g,g,g,g,g,g,f,g,R,;
R,g,g,g,g,g,g,g,d,g,R,;
R,g,g,g,g,g,g,d,g,g,R,;
R,g,g,g,g,g,d,g,g,g,R,;
R,g,d,d,g,g,d,g,g,g,R,;
R,g,g,g,d,g,d,d,d,g,R,;
R,g,g,g,g,d,X,g,g,g,R,;
R,g,g,g,g,g,g,g,g,g,R,;
R,g,g,g,g,g,g,g,g,g,R,;
R,g,g,g,g,g,g,g,g,g,R,;
R,g,g,g,g,g,g,g,g,g,R,;
R,R,R,R,R,R,R,R,R,R,R,;
