level,5;|R,R,R,R,R,R,R,R,R,R,R,;
R,g,g,g,g,g,g,g,g,g,R,;
R,g,g,g,g,g,g,g,g,g,R,;
R,d,X,g,g,g,g,g,g,g,R,;
R,d,g,g,g,g,g,g,g,g,R,;
R,d,d,g,g,g,g,g,g,g,R,;
R,d,g,d,g,g,g,g,g,g,R,;
R,69,g,g,d,g,d,d,73,g,R,;
R,g,g,g,g,d,g,g,g,g,R,;
R,g,g,g,g,g,g,g,g,g,R,;
R,g,g,g,g,g,g,g,g,g,R,;
R,g,g,g,g,g,g,g,g,g,R,;
R,R,R,R,R,R,R,R,R,R,R,;
