level,5;|R,R,R,R,R,R,R,R,R,R,R,R,R,R,;
R,g,g,g,g,g,93,g,g,g,g,g,g,R,;
R,d,g,g,g,g,d,g,g,g,g,g,g,R,;
R,g,g,g,g,g,d,g,g,g,g,g,g,R,;
R,g,g,g,g,g,d,g,g,g,g,g,g,R,;
R,g,g,g,g,g,d,g,g,g,g,g,g,R,;
R,g,g,g,g,g,d,g,g,g,g,g,g,R,;
R,g,g,g,g,g,g,d,g,g,g,g,g,R,;
R,g,92,d,d,g,d,d,d,g,g,g,g,R,;
R,g,g,g,g,d,g,g,g,d,X,g,g,R,;
R,g,g,g,g,g,g,g,g,g,g,g,g,R,;
R,g,g,g,g,g,g,g,g,g,g,g,g,R,;
R,g,g,g,g,g,g,g,g,g,g,g,g,R,;
R,R,R,R,R,R,R,R,R,R,R,R,R,R,;
