level,6;|R,R,R,R,R,R,R,R,R,R,R,;
R,g,g,g,g,g,93,g,93,g,R,;
R,g,g,g,g,g,g,d,d,g,R,;
R,g,g,g,g,g,d,d,g,g,R,;
R,g,d,g,g,g,90,g,g,g,R,;
R,g,g,g,g,g,d,d,91,g,R,;
R,g,g,g,g,d,g,g,g,g,R,;
R,g,g,g,d,g,g,g,g,g,R,;
R,g,g,d,X,g,g,g,g,g,R,;
R,g,g,g,g,g,g,g,g,g,R,;
R,g,g,g,g,g,g,g,g,g,R,;
R,g,g,g,g,g,g,g,g,g,R,;
R,R,R,R,R,R,R,R,R,R,R,;
