music,music_Medieval;
|
g,g,g,g,d,0,g,t,g,g,;
g,8,g,g,d,t,g,t,g,g,;
g,d,t,t,d,g,g,t,g,g,;
t,d,t,d,g,t,g,g,g,g,;
g,g,d,t,g,t,g,g,g,g,;
t,t,g,g,g,g,g,g,g,g,;
g,g,g,g,g,g,g,g,g,g,;
g,g,g,g,g,g,t,g,g,g,;
g,g,g,g,g,g,g,g,g,g,;
g,g,g,g,g,g,g,g,g,g,;
t,g,t,g,g,g,g,g,g,g,;
t,g,g,g,g,g,g,g,g,t,;
g,g,g,g,g,g,g,g,g,g,;