level,6;|R,R,R,R,R,R,R,R,R,R,R,R,;
R,g,g,g,g,g,g,g,g,g,g,R,;
R,g,g,g,g,g,g,g,g,g,g,R,;
R,87,86,d,85,g,g,g,g,g,g,R,;
R,87,d,d,d,g,g,g,g,g,g,R,;
R,g,g,g,g,d,d,g,g,g,g,R,;
R,g,g,g,g,g,d,d,X,g,g,R,;
R,g,g,g,g,d,d,d,g,g,g,R,;
R,g,g,g,d,g,d,g,g,g,g,R,;
R,g,g,g,85,g,g,g,g,g,g,R,;
R,g,g,g,g,g,g,g,g,g,g,R,;
R,g,g,g,g,g,g,g,g,g,g,R,;
R,R,R,R,R,R,R,R,R,R,R,R,;
