R,R,R,R,R,R,R,R,R,R,R,;
R, , , , , , , , ,G,R,;
R, , ,S, , , , , , ,R,;
R, , , , , , , , ,O,R,;
R, , ,C, , , , , , ,R,;
R, , , , , , ,G, , ,R,;
R, ,O, , , , ,g, , ,R,;
R, , , , , , , , ,S,R,;
R, , , , , , , , ,F,R,;
R,F, , , , ,S, , , ,R,;
R, , ,G, , , , , , ,R,;
R,F, ,F, , , , , , ,R,;
R,R,R,R,R,R,R,R,R,R,R,;
