R,R,R,R,R,R,R,R,R,R,R,R,R,R,;
R, , ,t, , , , , ,G,W, , ,R,;
R, , ,S, , , , , , , , , ,R,;
R, , , , , ,O, , , , , , ,R,;
R, , , , , , , , , ,t, , ,R,;
R, , , , , , , , , ,G, , ,R,;
R, , , , , , ,C, , , , , ,R,;
R, , , ,t, , ,W, , , , ,g,R,;
R, , ,F, , , , , ,g, , , ,R,;
R, , , , , ,S,F, , , , , ,R,;
R, , , , , , , , ,G, , , ,R,;
R, , , , , ,F,t, , , , , ,R,;
R,R,R,R,R,R,R,R,R,R,R,R,R,R,;
