level,5;|R,R,R,R,R,R,R,R,R,R,R,;
R,g,g,g,g,g,g,g,g,g,R,;
R,g,g,g,g,g,g,g,g,g,R,;
R,g,g,77,g,g,g,g,g,g,R,;
R,76,g,d,g,g,76,g,g,g,R,;
R,d,g,d,g,g,d,g,g,g,R,;
R,d,g,d,g,d,g,g,g,g,R,;
R,d,d,d,d,g,g,g,g,g,R,;
R,d,d,d,g,g,g,g,g,g,R,;
R,X,d,g,g,g,g,g,g,g,R,;
R,d,g,g,g,g,g,g,g,g,R,;
R,g,g,g,g,g,g,g,g,g,R,;
R,R,R,R,R,R,R,R,R,R,R,;
