level,2;|R,R,R,R,R,R,R,R,R,R,R,R,R,;
R,g,g,g,d,g,g,g,g,d,34,g,R,;
R,g,34,d,d,g,g,g,d,g,g,g,R,;
R,g,g,g,g,d,g,d,g,g,g,g,R,;
R,g,g,g,g,g,d,X,g,g,g,g,R,;
R,g,g,g,g,d,g,d,d,g,34,g,R,;
R,g,g,g,g,d,g,g,g,d,g,g,R,;
R,g,g,g,g,d,g,g,g,g,g,g,R,;
R,g,g,g,g,g,g,d,g,g,g,g,R,;
R,g,g,g,g,g,g,g,g,g,d,g,R,;
R,g,g,g,g,g,g,g,g,d,g,g,R,;
R,g,g,g,g,g,g,g,g,g,g,g,R,;
R,R,R,R,R,R,R,R,R,R,R,R,R,;
