level,7;|R,R,R,R,R,R,R,R,R,R,R,;
R,g,g,g,g,g,g,g,g,g,R,;
R,g,g,g,g,g,d,X,g,g,R,;
R,g,g,g,g,g,g,d,g,g,R,;
R,g,g,g,g,g,d,g,g,g,R,;
R,g,g,g,g,g,g,d,g,g,R,;
R,g,g,g,g,g,g,d,g,g,R,;
R,g,g,g,g,g,g,94,g,g,R,;
R,g,g,g,g,g,g,g,g,g,R,;
R,g,g,g,g,g,g,g,g,g,R,;
R,g,g,d,g,g,g,g,g,g,R,;
R,g,g,g,g,g,g,g,g,g,R,;
R,R,R,R,R,R,R,R,R,R,R,;
