level,7;|R,R,R,R,R,R,R,R,R,R,R,;
R,g,g,g,g,g,g,g,g,g,R,;
R,g,g,g,g,g,g,g,g,g,R,;
R,g,g,g,g,g,g,g,g,g,R,;
R,g,g,g,g,g,g,f,g,g,R,;
R,g,g,g,g,g,g,d,g,g,R,;
R,g,g,g,f,d,d,g,g,g,R,;
R,g,g,g,d,g,g,g,g,g,R,;
R,X,d,d,g,g,g,g,g,g,R,;
R,d,g,g,d,g,f,g,g,g,R,;
R,g,d,d,g,d,g,g,g,g,R,;
R,g,g,d,d,d,f,g,g,g,R,;
R,g,g,g,g,g,g,g,g,g,R,;
R,g,g,g,g,g,g,g,g,g,R,;
R,R,R,R,R,R,R,R,R,R,R,;
