level,7;|R,R,R,R,R,R,R,R,R,R,R,;
R,g,g,d,g,d,g,g,g,g,R,;
R,g,g,g,d,g,d,X,g,g,R,;
R,g,g,g,g,g,d,d,g,g,R,;
R,g,g,g,g,g,d,d,g,g,R,;
R,f,d,d,d,g,d,g,g,g,R,;
R,g,g,g,g,d,f,g,g,g,R,;
R,g,g,g,g,g,g,g,g,g,R,;
R,g,g,g,g,g,g,g,d,g,R,;
R,g,g,g,g,g,g,g,g,g,R,;
R,g,g,g,d,g,g,g,g,g,R,;
R,g,g,g,g,g,g,g,g,g,R,;
R,g,g,g,g,g,g,g,g,g,R,;
R,g,g,g,g,g,g,g,g,g,R,;
R,g,g,g,g,g,g,g,g,g,R,;
R,R,R,R,R,R,R,R,R,R,R,;
