R,R,R,R,R,R,R,R,R,R,R,;
R, , , , , , , , , ,R,;
R, , ,G, , , , , ,S,R,;
R,O, , , , , ,S, ,F,R,;
R,G, , , , , , , , ,R,;
R,F, , , , , , , ,O,R,;
R, , ,F, ,O, , , , ,R,;
R, , , , , , , , , ,R,;
R, , , , , , , , ,S,R,;
R,C, ,S, , , , , , ,R,;
R,O,G, ,G, , , , ,G,R,;
R, , ,F,O, , , , , ,R,;
R,F, , , , , ,G, , ,R,;
R, ,O, , , , , , , ,R,;
R,R,R,R,R,R,R,R,R,R,R,;
