R,R,R,R,R,R,R,R,R,R,R,R,R,;
R, , , ,t, , ,W, , , , ,R,;
R, , ,g, , , , , , ,S, ,R,;
R, , , , ,W, , , , , , ,R,;
R, , ,t, , , , , , , , ,R,;
R, ,G, , , , , , , , , ,R,;
R, ,g, ,W, , , , , , , ,R,;
R, , , , ,t, ,g, , , , ,R,;
R, , , , , , , , ,F, , ,R,;
R, , , , ,t, , , ,S, , ,R,;
R, , ,C, , , , , , , , ,R,;
R, ,t,F, , , , , , , , ,R,;
R,R,R,R,R,R,R,R,R,R,R,R,R,;
