level,2;|R,R,R,R,R,R,R,R,R,R,R,;
R,g,g,d,g,g,g,g,g,g,R,;
R,g,g,g,42,g,g,g,g,g,R,;
R,g,g,g,d,g,g,g,g,g,R,;
R,g,40,g,d,g,g,g,g,g,R,;
R,g,d,g,d,g,g,g,g,g,R,;
R,g,d,g,d,g,g,g,g,g,R,;
R,g,g,d,d,d,g,g,g,g,R,;
R,g,g,d,d,X,d,d,g,g,R,;
R,g,d,g,g,g,d,g,g,g,R,;
R,d,g,g,g,g,g,g,g,g,R,;
R,g,g,g,g,g,g,g,g,g,R,;
R,g,g,g,g,g,g,g,g,g,R,;
R,g,g,g,g,g,g,g,g,g,R,;
R,R,R,R,R,R,R,R,R,R,R,;
