R,R,R,R,R,R,R,R,R,R,R,;
R, ,C, , , , , , ,t,R,;
R, , ,S,g, , , , , ,R,;
R, , , , , , , , ,O,R,;
R, , , ,t, , , , , ,R,;
R, , , , , , ,G, , ,R,;
R, ,W, , , , ,g, , ,R,;
R, , , , , , , , ,g,R,;
R, , , , , , , , ,F,R,;
R,F, , , , ,S, , , ,R,;
R, , ,G, , , , , , ,R,;
R,t, ,F, , , , , , ,R,;
R,R,R,R,R,R,R,R,R,R,R,;
