level,4;|R,R,R,R,R,R,R,R,R,R,R,;
R,g,d,g,g,g,g,g,g,g,R,;
R,g,g,g,g,g,g,g,g,g,R,;
R,62,g,g,g,g,g,g,g,g,R,;
R,g,d,d,g,g,g,g,g,g,R,;
R,62,d,d,d,g,d,g,g,g,R,;
R,62,d,d,d,d,d,g,g,g,R,;
R,g,g,g,g,g,d,g,g,g,R,;
R,g,g,g,g,g,g,d,X,g,R,;
R,g,g,d,g,g,d,d,g,g,R,;
R,g,g,g,g,d,g,d,g,g,R,;
R,g,g,g,g,d,g,d,g,g,R,;
R,g,g,g,g,60,g,g,g,g,R,;
R,g,g,g,g,g,g,g,g,g,R,;
R,R,R,R,R,R,R,R,R,R,R,;
