level,2;|R,R,R,R,R,R,R,R,R,R,R,R,R,R,;
R,g,g,g,g,g,g,g,g,g,g,g,g,R,;
R,g,50,g,g,g,g,g,g,g,g,g,g,R,;
R,g,d,g,g,g,g,g,g,g,g,g,g,R,;
R,g,g,d,g,g,g,g,g,g,d,g,g,R,;
R,g,g,g,d,d,g,g,g,g,g,g,g,R,;
R,g,g,g,g,g,d,g,g,g,g,g,g,R,;
R,g,g,g,g,g,g,d,g,g,g,g,g,R,;
R,50,d,d,d,g,d,d,d,g,g,g,g,R,;
R,g,g,g,g,d,g,g,g,d,g,g,g,R,;
R,g,g,g,g,g,g,g,g,g,d,X,g,R,;
R,g,g,g,g,g,g,g,g,g,g,g,g,R,;
R,g,g,g,g,g,g,g,g,g,g,g,g,R,;
R,R,R,R,R,R,R,R,R,R,R,R,R,R,;
