level,5;|R,R,R,R,R,R,R,R,R,R,R,R,;
R,g,g,g,g,g,d,g,g,g,g,R,;
R,g,77,g,d,d,d,X,g,g,g,R,;
R,g,g,d,g,d,d,g,g,g,g,R,;
R,g,77,d,d,d,d,g,g,g,g,R,;
R,g,g,g,g,g,d,g,g,g,g,R,;
R,g,g,g,g,g,g,g,g,g,g,R,;
R,g,g,g,g,g,g,g,g,g,g,R,;
R,g,g,g,g,g,g,g,g,g,g,R,;
R,g,g,g,g,g,g,g,g,g,g,R,;
R,g,g,d,d,g,g,g,g,g,g,R,;
R,g,g,g,g,g,g,g,g,g,g,R,;
R,R,R,R,R,R,R,R,R,R,R,R,;
