R,R,R,R,R,R,R,R,R,R,R,;
R, , , , , , , , ,t,R,;
R, , , ,g, , , , , ,R,;
R, , , , , , , , ,W,R,;
R, , , ,t, , , , , ,R,;
R, , , , , , ,G, , ,R,;
R, ,W, , , , ,g, , ,R,;
R, , , , , , , , ,g,R,;
R, , , , , , , , ,g,R,;
R,t, , , ,C, , , , ,R,;
R, , ,G, , , , , , ,R,;
R,t, ,F, , , , , , ,R,;
R,R,R,R,R,R,R,R,R,R,R,;
