R,R,R,R,R,R,R,R,R,R,R,;
R, , , , , , ,G, , ,R,;
R, , , , , , , , , ,R,;
R, , ,S, , , , , ,G,R,;
R,W, ,G, , , , , , ,R,;
R, , , ,G, , ,S, , ,R,;
R, , , , , , , , ,S,R,;
R,t, , , ,W, , , , ,R,;
R, , , , , , , , , ,R,;
R,F, , , , , , , , ,R,;
R, , , , , , , , , ,R,;
R, , ,F,C, , , , ,S,R,;
R, , , , , , , , , ,R,;
R,F, , , , ,S, , , ,R,;
R, ,O, , , , , , ,F,R,;
R, , , ,O, , , , , ,R,;
R,R,R,R,R,R,R,R,R,R,R,;
