level,7;|R,R,R,R,R,R,R,R,R,R,R,;
R,g,g,g,g,g,g,d,g,g,R,;
R,g,g,g,g,g,g,g,g,g,R,;
R,g,g,g,g,g,g,g,g,g,R,;
R,g,g,d,g,d,d,g,g,g,R,;
R,g,g,d,X,d,g,g,g,g,R,;
R,g,g,g,d,d,d,98,g,g,R,;
R,g,g,g,d,g,d,g,g,g,R,;
R,g,g,g,d,g,g,g,g,g,R,;
R,g,g,g,98,g,g,g,g,g,R,;
R,g,g,g,g,g,g,g,g,g,R,;
R,g,g,g,g,g,g,g,g,g,R,;
R,R,R,R,R,R,R,R,R,R,R,;
