level,3;|R,R,R,R,R,R,R,R,R,R,R,;
R,g,g,g,g,g,59,g,g,g,R,;
R,d,g,g,g,g,d,g,g,g,R,;
R,X,g,g,g,d,g,g,g,g,R,;
R,d,d,d,d,g,g,g,g,g,R,;
R,g,d,d,d,57,g,g,g,g,R,;
R,g,g,d,d,d,d,59,g,g,R,;
R,g,g,g,d,g,58,59,g,g,R,;
R,g,d,g,g,g,g,g,g,g,R,;
R,d,g,g,g,g,g,g,g,g,R,;
R,g,g,g,g,d,g,g,g,g,R,;
R,g,g,g,g,g,g,g,g,g,R,;
R,g,g,g,g,g,g,g,g,g,R,;
R,g,g,g,g,g,g,g,g,g,R,;
R,g,g,g,g,d,g,g,g,g,R,;
R,g,g,g,g,g,g,g,g,g,R,;
R,R,R,R,R,R,R,R,R,R,R,;
