R,R,R,R,R,R,R,R,R,R,R,R,R,R,;
R, ,O, , , , ,F, , ,G, , ,R,;
R, , , , , ,O, , , , , , ,R,;
R, , , , , , ,S, , , , , ,R,;
R, , , ,F, ,S, , , ,G, , ,R,;
R, , ,F, , ,F, ,O, , , , ,R,;
R, , , , , , ,O, ,G, , , ,R,;
R, , , , , , , , ,G, , , ,R,;
R, , , , , , , , , , , ,S,R,;
R, , , , , , ,F, ,C, , , ,R,;
R, , , ,O, , , , , ,O, , ,R,;
R, ,G,F,S, , , , , ,G, , ,R,;
R,S, ,S, , , , , , , , , ,R,;
R,R,R,R,R,R,R,R,R,R,R,R,R,R,;
