R,R,R,R,R,R,R,R,R,R,R,R,;
R,F, , , , , , , ,G, ,R,;
R, , , , ,S, , , , , ,R,;
R, , , , , , , , , , ,R,;
R, , , , , , , , , ,G,R,;
R, , , ,G, , , , , , ,R,;
R, ,O, , , , ,C, , , ,R,;
R, , , , , , , , ,O,S,R,;
R, , , , ,S, , , , , ,R,;
R, , , , , , ,F, , ,S,R,;
R, , , , , , , , ,G, ,R,;
R, , ,F,F, , , , , , ,R,;
R,R,R,R,R,R,R,R,R,R,R,R,;
