R,R,R,R,R,R,R,R,R,R,R,;
R, , , , , , , , ,G,R,;
R, , ,S,S, , , , , ,R,;
R, , , , , , , , ,O,R,;
R, , , ,G, , , , , ,R,;
R, , , , , , ,G, , ,R,;
R, ,O, , , , ,g, , ,R,;
R, , , , , , , , ,S,R,;
R, , , , , , , , ,F,R,;
R, , , , , ,S, , , ,R,;
R,C, ,G, , , , , , ,R,;
R,F, ,F, , , , , , ,R,;
R,R,R,R,R,R,R,R,R,R,R,;
