R,R,R,R,R,R,R,R,R,R,R,;
R, , , , , , , , ,t,R,;
R, , ,S,g, , , , , ,R,;
R, , , , , , , , ,W,R,;
R, , , ,t, , , , , ,R,;
R, , , , , ,C, , , ,R,;
R, ,W, , , , ,g, , ,R,;
R, , , , , , , , ,g,R,;
R, , , , , , , , ,F,R,;
R,F, , , , ,S, , , ,R,;
R, , ,G, , , , , , ,R,;
R,t, ,F, , , , , , ,R,;
R,R,R,R,R,R,R,R,R,R,R,;
