level,6;|R,R,R,R,R,R,R,R,R,R,R,R,;
R,g,g,g,g,g,g,g,g,g,g,R,;
R,g,g,g,g,g,g,d,d,96,g,R,;
R,g,g,g,g,d,d,g,g,g,g,R,;
R,g,g,g,d,g,g,g,g,g,g,R,;
R,g,g,d,g,g,g,g,g,g,g,R,;
R,X,d,g,g,g,g,g,g,g,g,R,;
R,d,g,g,g,g,g,g,g,g,g,R,;
R,g,g,g,g,g,g,g,g,g,g,R,;
R,g,g,g,g,g,g,g,g,g,g,R,;
R,g,g,g,g,g,g,g,g,g,g,R,;
R,g,g,g,g,g,g,g,g,g,g,R,;
R,R,R,R,R,R,R,R,R,R,R,R,;
