R,R,R,R,R,R,R,R,R,R,R,;
R, , ,F, , , , , ,G,R,;
R, , ,S,S, ,C, , , ,R,;
R, , , , , , , , ,O,R,;
R, , , ,G, , , , , ,R,;
R, , , , , , ,G, , ,R,;
R, ,O, , , , ,S, , ,R,;
R, , , ,O, , , , ,S,R,;
R, , , , , , , , ,S,R,;
R,F, , , , ,S, , , ,R,;
R, , , , , , , , , ,R,;
R,F, ,F, , , , , , ,R,;
R,R,R,R,R,R,R,R,R,R,R,;
