level,6;|R,R,R,R,R,R,R,R,R,R,R,;
R,g,g,90,g,g,g,g,g,g,R,;
R,g,g,d,g,g,g,g,g,g,R,;
R,g,g,d,g,g,g,g,g,g,R,;
R,g,g,d,87,g,g,g,g,g,R,;
R,g,d,d,d,g,g,g,g,g,R,;
R,g,d,d,d,g,g,g,g,g,R,;
R,g,d,d,d,g,d,g,g,g,R,;
R,g,g,d,X,g,g,g,g,g,R,;
R,g,d,g,g,g,g,g,g,g,R,;
R,g,g,g,g,g,g,g,g,g,R,;
R,g,g,g,g,g,g,g,g,g,R,;
R,R,R,R,R,R,R,R,R,R,R,;
