level,2;|R,R,R,R,R,R,R,R,R,R,R,;
R,g,39,g,g,g,39,g,g,g,R,;
R,g,39,d,g,g,g,d,g,g,R,;
R,g,g,g,d,d,d,d,g,g,R,;
R,40,d,d,g,d,d,d,d,g,R,;
R,g,g,g,d,g,d,X,g,g,R,;
R,g,g,g,g,g,g,g,g,g,R,;
R,g,g,g,g,g,g,g,g,g,R,;
R,g,g,g,g,g,g,g,g,g,R,;
R,g,g,g,g,g,g,g,g,g,R,;
R,g,g,g,g,g,g,d,g,g,R,;
R,g,g,g,g,g,g,g,g,g,R,;
R,R,R,R,R,R,R,R,R,R,R,;
