R,R,R,R,R,R,R,R,R,R,R,R,R,R,;
R, ,W,t, , , , , ,G,W, , ,R,;
R, , ,S, , , ,S, , , , , ,R,;
R, , , , , ,O, , , , , , ,R,;
R, , , , , , , , , ,G, , ,R,;
R, , , , , , , , , ,G, , ,R,;
R, , , , , , , ,O, , , , ,R,;
R, , , ,t, , ,W, , , , ,S,R,;
R, , ,F, , , , , ,S, , , ,R,;
R, , , , , ,S,F, , ,t, , ,R,;
R, , , ,C, , , , ,G, , , ,R,;
R, , , , , ,F,F, , , , , ,R,;
R,R,R,R,R,R,R,R,R,R,R,R,R,R,;
