level,6;|R,R,R,R,R,R,R,R,R,R,R,;
R,g,g,g,g,d,g,g,g,g,R,;
R,g,g,g,d,d,g,g,g,g,R,;
R,g,g,g,d,d,d,g,g,g,R,;
R,g,g,g,g,d,d,d,X,g,R,;
R,g,g,g,g,g,d,g,g,g,R,;
R,g,g,g,g,g,d,g,g,g,R,;
R,g,g,g,g,g,g,d,g,g,R,;
R,g,g,g,g,g,d,g,g,g,R,;
R,g,g,g,g,92,g,g,g,g,R,;
R,g,g,g,g,d,g,g,g,g,R,;
R,g,g,g,g,g,g,g,g,g,R,;
R,R,R,R,R,R,R,R,R,R,R,;
