R,R,R,R,R,R,R,R,R,R,R,;
R, , , , , , , , , ,R,;
R, , ,G, , , , , ,g,R,;
R, , , , , , ,g, ,F,R,;
R, , , , , , , , , ,R,;
R,t, , , , , , , ,O,R,;
R, , ,F, , , , , , ,R,;
R, , , , , , , , , ,R,;
R, , , , , , , , ,g,R,;
R,F, ,S, , , , , , ,R,;
R, , , ,C, , , , ,G,R,;
R, , ,t,W, ,S, , , ,R,;
R,t, , , , , ,G, , ,R,;
R, ,W, , , , , , , ,R,;
R,R,R,R,R,R,R,R,R,R,R,;
