level,3;|R,R,R,R,R,R,R,R,R,R,R,;
R,g,d,X,g,g,g,g,g,g,R,;
R,g,g,d,g,g,g,g,g,g,R,;
R,g,g,g,d,g,g,g,g,g,R,;
R,g,g,g,g,d,d,44,g,g,R,;
R,g,g,g,g,g,g,g,g,g,R,;
R,g,g,g,g,g,g,g,g,g,R,;
R,g,g,g,g,g,g,g,g,g,R,;
R,g,g,g,g,g,g,g,g,g,R,;
R,g,g,g,g,g,g,g,g,g,R,;
R,g,g,g,g,g,g,g,g,g,R,;
R,g,g,g,g,g,g,g,g,g,R,;
R,R,R,R,R,R,R,R,R,R,R,;
