level,2;music,music_Hellish;
|
g,g,g,g,g,g,g,g;
g,g,g,g,c,g,g,g;
g,g,g,g,c,g,g,g;
g,g,g,c,c,g,g,g;
g,g,g,c,g,g,g,g;
g,W,W,c,g,g,g,g;
g,c,c,c,g,g,g,g;
g,g,g,g,g,g,g,g;