level,3;|R,R,R,R,R,R,R,R,R,R,R,;
R,g,g,g,g,g,g,g,g,g,R,;
R,g,g,g,g,g,g,d,g,g,R,;
R,g,g,g,g,d,d,g,g,g,R,;
R,g,g,g,d,X,g,g,g,g,R,;
R,g,g,d,g,d,g,g,g,g,R,;
R,g,d,g,g,g,d,g,g,g,R,;
R,d,g,g,g,g,g,d,g,g,R,;
R,g,g,g,g,g,g,d,g,g,R,;
R,g,g,g,g,g,g,52,g,g,R,;
R,g,g,g,g,g,g,g,g,g,R,;
R,g,g,g,g,g,g,g,g,g,R,;
R,R,R,R,R,R,R,R,R,R,R,;
