level,3;|R,R,R,R,R,R,R,R,R,R,R,;
R,g,g,g,54,g,54,g,g,g,R,;
R,g,g,g,d,g,g,d,g,g,R,;
R,g,g,g,d,g,d,g,g,g,R,;
R,g,g,g,g,d,d,g,g,g,R,;
R,50,g,g,d,g,d,g,g,g,R,;
R,d,g,g,49,g,d,g,g,g,R,;
R,d,g,g,d,g,d,g,g,g,R,;
R,d,g,g,d,d,g,g,g,g,R,;
R,g,d,g,d,g,g,g,g,g,R,;
R,g,g,d,X,g,g,g,g,g,R,;
R,g,g,g,g,g,g,g,g,g,R,;
R,R,R,R,R,R,R,R,R,R,R,;
