level,6;|R,R,R,R,R,R,R,R,R,R,R,R,R,R,;
R,g,g,g,g,g,g,g,g,g,g,g,g,R,;
R,g,g,g,g,g,g,g,g,g,g,g,g,R,;
R,g,g,g,g,g,g,g,g,g,g,g,g,R,;
R,g,g,g,g,f,d,d,g,g,g,g,g,R,;
R,g,g,g,g,g,g,g,d,g,g,g,g,R,;
R,g,g,f,g,g,d,d,d,d,X,g,g,R,;
R,g,g,g,d,d,g,g,d,g,d,g,g,R,;
R,g,g,g,g,g,g,d,d,g,g,d,g,R,;
R,g,g,g,g,g,g,g,d,g,g,g,g,R,;
R,g,g,g,g,g,g,f,f,g,g,g,g,R,;
R,g,g,g,g,g,g,g,g,g,g,g,g,R,;
R,g,g,g,g,g,g,g,g,g,g,g,g,R,;
R,R,R,R,R,R,R,R,R,R,R,R,R,R,;
