level,5;|R,R,R,R,R,R,R,R,R,R,R,;
R,g,g,g,g,g,d,X,g,g,R,;
R,g,g,g,g,g,d,d,g,g,R,;
R,g,g,g,g,g,d,d,g,g,R,;
R,g,g,g,g,g,d,d,g,g,R,;
R,g,g,g,g,g,d,72,g,g,R,;
R,g,g,75,d,d,g,g,g,g,R,;
R,g,g,g,g,g,g,g,g,g,R,;
R,g,g,g,g,g,g,g,g,g,R,;
R,g,g,g,g,g,g,g,g,g,R,;
R,g,d,g,g,g,d,g,d,g,R,;
R,d,d,g,g,g,g,d,g,g,R,;
R,g,g,g,g,g,g,g,g,g,R,;
R,g,g,g,g,g,g,g,g,g,R,;
R,g,g,g,g,g,g,g,g,g,R,;
R,R,R,R,R,R,R,R,R,R,R,;
