R,R,R,R,R,R,R,R,R,R,R,;
R,t, , , , , , , , ,R,;
R, , , , , , , , ,O,R,;
R, , , , , ,C, , , ,R,;
R, , , , , ,S,G, , ,R,;
R, ,O,F, , , , , , ,R,;
R, , , ,W, , , , ,G,R,;
R, , ,G, , , , , , ,R,;
R, , , , , , , , ,g,R,;
R, , , , , , , , ,g,R,;
R, , , , , , , , , ,R,;
R, , , ,t, , ,g, ,F,R,;
R, , ,S, , , , , , ,R,;
R,R,R,R,R,R,R,R,R,R,R,;
