R,R,R,R,R,R,R,R,R,R,R,;
R, , , , , , , , ,G,R,;
R, , ,S, , , , , , ,R,;
R, , , , , , , , ,O,R,;
R, , , ,G, , ,C, , ,R,;
R, , , , , , ,G, , ,R,;
R, ,O, , , , ,S, , ,R,;
R, , , ,O, , , , ,S,R,;
R, , , , , , , , ,S,R,;
R,F, , , , ,S, , , ,R,;
R, , ,G, , , , , , ,R,;
R,F, ,F, , , , , , ,R,;
R,R,R,R,R,R,R,R,R,R,R,;
