level,1;|R,R,R,R,R,R,R,R,R,R,R,;
R,g,g,g,g,g,g,g,g,g,R,;
R,g,g,g,g,g,g,g,g,g,R,;
R,g,g,g,g,g,g,g,g,g,R,;
R,g,d,d,g,g,g,g,g,g,R,;
R,g,g,g,d,g,g,g,g,g,R,;
R,g,g,g,g,d,X,g,g,g,R,;
R,g,g,g,d,g,g,g,g,g,R,;
R,5,d,d,g,g,g,g,g,g,R,;
R,g,g,g,g,g,g,g,g,g,R,;
R,g,g,g,g,g,d,g,g,g,R,;
R,g,g,g,g,g,g,g,g,g,R,;
R,R,R,R,R,R,R,R,R,R,R,;
