R,R,R,R,R,R,R,R,R,R,R,;
R, , ,F, , , , , ,G,R,;
R, , ,S,S, , , , , ,R,;
R, , , , , , , , ,O,R,;
R, , , ,G, , , , , ,R,;
R, , , , , , ,G, , ,R,;
R, ,O, , , , ,S, , ,R,;
R,F, , , , , , , ,S,R,;
R, , , , , , , , ,S,R,;
R,C, , , , ,S, , , ,R,;
R, , ,G, , , , , , ,R,;
R,F, ,F, , , , , , ,R,;
R,R,R,R,R,R,R,R,R,R,R,;
