R,R,R,R,R,R,R,R,R,R,R,;
R, , ,t, , , ,g, , ,R,;
R, , , , , , , , , ,R,;
R, , , , , , , , , ,R,;
R,W, , , , , , , ,S,R,;
R, , ,F,G,W, , , , ,R,;
R, , , , , , , , , ,R,;
R, , , , , , , , ,F,R,;
R, , , ,W, , , , , ,R,;
R,F, ,G, , , , , , ,R,;
R, , , , ,C, ,G, , ,R,;
R, , , , , , , , ,g,R,;
R, , , , , ,S, , , ,R,;
R,F, , , , , , , , ,R,;
R,t, , , , , , , ,G,R,;
R,R,R,R,R,R,R,R,R,R,R,;
