R,R,R,R,R,R,R,R,R,R,R,R,R,;
R, , , ,C, , ,W, , , , ,R,;
R, , ,S, , , , , , ,S, ,R,;
R, , , , ,O, , , , , , ,R,;
R, , ,G, , , , , , , , ,R,;
R, ,G, , , , , , , , , ,R,;
R, ,S, ,O, , , , , , , ,R,;
R, , , , ,t, ,S, , , , ,R,;
R, , , , , , , , ,F, , ,R,;
R, , , , ,F, , , ,S, , ,R,;
R, , , , , ,G, , , , , ,R,;
R, ,F,F, , , , , , , , ,R,;
R,R,R,R,R,R,R,R,R,R,R,R,R,;
