R,R,R,R,R,R,R,R,R,R,R,R,;
R,t, , , , , , , ,G, ,R,;
R, , , , ,S, , , , , ,R,;
R, ,O, , , , , , , , ,R,;
R, , , , , , , , , ,G,R,;
R, , , ,G, , , , , , ,R,;
R, , , , , , , ,S, , ,R,;
R, , , , , , , , ,O,S,R,;
R, ,C, , ,S, , , , , ,R,;
R, , , , , , ,F, , ,S,R,;
R, , , , , , , , ,G, ,R,;
R, , ,F,F, , , , , , ,R,;
R,R,R,R,R,R,R,R,R,R,R,R,;
