R,R,R,R,R,R,R,R,R,R,R,R,R,;
R, , , , , , ,W, , , , ,R,;
R, , ,g, , , , , , ,S, ,R,;
R, , , , ,W, , , , , , ,R,;
R, , ,t, , ,C, , , , , ,R,;
R, ,G, , , , , , , , , ,R,;
R, ,g, ,W, , , , , , , ,R,;
R, , , , , , ,g, , , , ,R,;
R, , , , , , , , ,F, , ,R,;
R, , , , ,F, , , ,S, , ,R,;
R, , , , , ,G, , , , , ,R,;
R, ,t,F, , , , , , , , ,R,;
R,R,R,R,R,R,R,R,R,R,R,R,R,;
