level,1;|R,R,R,R,R,R,R,R,R,R,R,;
R,g,d,d,d,X,d,g,g,g,R,;
R,g,g,d,g,d,d,g,g,g,R,;
R,d,d,g,g,d,g,g,g,g,R,;
R,g,g,g,g,d,g,g,g,g,R,;
R,g,g,g,g,d,g,g,g,g,R,;
R,g,g,g,g,11,g,g,g,g,R,;
R,g,g,g,g,g,g,g,g,g,R,;
R,g,g,g,g,g,g,g,g,g,R,;
R,g,g,g,g,g,g,g,g,g,R,;
R,g,g,g,g,g,g,g,g,g,R,;
R,g,g,g,g,g,g,g,g,g,R,;
R,R,R,R,R,R,R,R,R,R,R,;
