level,4;|R,R,R,R,R,R,R,R,R,R,R,;
R,g,g,g,g,g,g,g,g,g,R,;
R,g,58,g,g,g,g,g,g,g,R,;
R,57,g,d,g,g,g,g,g,g,R,;
R,d,g,d,g,g,g,g,g,g,R,;
R,d,d,g,g,g,g,g,g,g,R,;
R,d,d,g,g,g,g,g,g,g,R,;
R,d,d,g,g,g,g,g,g,g,R,;
R,d,d,g,g,g,g,g,g,g,R,;
R,g,g,d,X,g,g,g,g,g,R,;
R,g,g,d,g,g,g,g,g,g,R,;
R,g,g,g,g,g,g,g,g,g,R,;
R,R,R,R,R,R,R,R,R,R,R,;
