level,2;|R,R,R,R,R,R,R,R,R,R,R,;
R,g,g,g,g,g,g,38,g,g,R,;
R,g,g,g,g,g,g,d,g,g,R,;
R,g,g,d,d,d,d,g,g,g,R,;
R,g,g,d,g,d,d,d,38,g,R,;
R,g,d,X,d,g,g,g,g,g,R,;
R,g,g,d,g,g,g,g,g,g,R,;
R,g,g,g,d,g,g,g,g,g,R,;
R,g,g,g,g,d,g,g,g,g,R,;
R,g,g,g,g,g,36,g,g,g,R,;
R,g,g,g,g,g,g,g,g,g,R,;
R,g,g,g,g,g,g,g,g,g,R,;
R,R,R,R,R,R,R,R,R,R,R,;
