R,R,R,R,R,R,R,R,R,R,R,R,R,R,;
R, ,O, , , ,G,F, , ,G, , ,R,;
R, , , , , ,O, , , , , , ,R,;
R, , ,G, , , ,S, , , , , ,R,;
R, , , ,F, ,S, , , ,G,F, ,R,;
R, , ,F, , ,F, ,O, , , , ,R,;
R, , , , , , ,O, ,C, , , ,R,;
R, , , , , , , , ,G, , , ,R,;
R, , , , , , , , , , , ,S,R,;
R, , , , , , ,F, ,S, , , ,R,;
R, , , ,O, , , , , ,O, , ,R,;
R, ,G,F,S, , , , , ,F, , ,R,;
R,S, ,S, , , , , , , , , ,R,;
R,R,R,R,R,R,R,R,R,R,R,R,R,R,;
