level,1;|R,R,R,R,R,R,R,R,R,R,R,R,R,;
R,g,g,g,g,g,g,g,g,g,g,g,R,;
R,g,g,18,d,g,d,d,d,d,X,g,R,;
R,g,g,g,g,d,g,g,d,g,g,g,R,;
R,g,19,d,d,d,g,d,d,g,g,g,R,;
R,g,g,g,g,g,d,g,d,g,g,g,R,;
R,g,g,g,g,g,g,g,g,g,g,g,R,;
R,g,g,g,g,g,g,g,g,g,g,g,R,;
R,g,g,g,g,g,g,g,g,g,g,g,R,;
R,g,g,g,g,g,g,g,g,g,g,g,R,;
R,g,g,g,g,g,g,g,g,g,g,g,R,;
R,g,g,g,g,g,g,g,g,g,g,g,R,;
R,R,R,R,R,R,R,R,R,R,R,R,R,;
