level,7;|R,R,R,R,R,R,R,R,R,R,R,;
R,g,g,g,g,g,g,g,g,g,R,;
R,g,g,g,g,f,g,f,g,g,R,;
R,g,d,g,g,d,g,d,g,g,R,;
R,g,g,g,g,d,f,g,g,g,R,;
R,g,g,g,g,d,g,g,g,g,R,;
R,g,g,g,d,g,g,g,g,g,R,;
R,g,g,d,d,g,g,f,g,g,R,;
R,g,d,g,g,d,d,g,g,g,R,;
R,d,X,d,g,g,g,g,g,g,R,;
R,g,g,g,g,g,g,g,g,g,R,;
R,g,g,g,g,g,g,g,g,g,R,;
R,R,R,R,R,R,R,R,R,R,R,;
