R,R,R,R,R,R,R,R,R,R,R,R,R,;
R, , , ,t, , ,W, , , , ,R,;
R, , , , , , , , ,C, , ,R,;
R, , , , ,W, , , , , , ,R,;
R, , ,t, , , , , , , , ,R,;
R, ,G, , , , , , , , , ,R,;
R, ,g, ,W, , , , , , , ,R,;
R, , , , ,t, ,g, , , , ,R,;
R, , , , , , , , ,g, , ,R,;
R, , , , ,t, , , ,g, , ,R,;
R, , , , , ,G, , , , , ,R,;
R, ,t,F, , , , , , , , ,R,;
R,R,R,R,R,R,R,R,R,R,R,R,R,;
