R,R,R,R,R,R,R,R,R,R,R,;
R, , , , , , , , ,G,R,;
R, , ,S,S, , , , , ,R,;
R, , , , , , , , ,O,R,;
R, , , ,t, , , , , ,R,;
R, , , , , , ,G, , ,R,;
R, ,W, , , , ,g, , ,R,;
R, , , , , , , , ,g,R,;
R, , , , , , , , ,F,R,;
R,F, ,C, , ,S, , , ,R,;
R, , , , , , , , , ,R,;
R,t, ,F, , , , , , ,R,;
R,R,R,R,R,R,R,R,R,R,R,;
