level,3;|R,R,R,R,R,R,R,R,R,R,R,;
R,g,g,g,d,X,d,d,g,g,R,;
R,g,d,d,d,g,g,g,g,g,R,;
R,g,g,g,g,d,g,g,g,g,R,;
R,g,g,g,g,d,d,g,g,g,R,;
R,g,g,g,g,d,d,d,g,g,R,;
R,g,g,g,g,d,54,g,d,g,R,;
R,g,g,g,d,g,55,g,55,g,R,;
R,g,g,g,g,d,g,g,g,g,R,;
R,g,g,g,g,57,g,g,g,g,R,;
R,g,g,g,g,g,g,d,g,g,R,;
R,g,g,g,g,g,g,g,g,g,R,;
R,R,R,R,R,R,R,R,R,R,R,;
