level,7;|R,R,R,R,R,R,R,R,R,R,R,R,;
R,g,g,g,g,g,g,g,g,g,g,R,;
R,g,g,d,g,g,g,d,d,97,g,R,;
R,g,g,g,g,d,X,g,g,g,g,R,;
R,g,g,g,g,g,d,g,g,g,g,R,;
R,g,g,g,g,g,d,d,g,g,g,R,;
R,g,g,g,g,g,d,g,d,g,g,R,;
R,g,g,g,g,g,g,g,d,g,g,R,;
R,g,g,g,g,g,g,g,g,98,g,R,;
R,g,g,g,g,g,g,g,g,g,g,R,;
R,g,g,g,g,g,g,d,g,g,g,R,;
R,g,g,g,g,g,g,g,g,g,g,R,;
R,R,R,R,R,R,R,R,R,R,R,R,;
