R,R,R,R,R,R,R,R,R,R,R,;
R, , ,t, , ,C, , , ,R,;
R, , , , , , , , , ,R,;
R, , , , , , , , , ,R,;
R,W, , , , , , , ,S,R,;
R, ,O,F,G,W, , , , ,R,;
R, , , , , , , , , ,R,;
R, , , , , , , , ,F,R,;
R, , , ,O, , , , , ,R,;
R,F, ,G, , , , , , ,R,;
R, , , , , , ,G, , ,R,;
R, , , ,S, , , , ,S,R,;
R, , ,S, , ,S, , , ,R,;
R,F, , , , , , , , ,R,;
R,t, , , , , , , ,G,R,;
R,R,R,R,R,R,R,R,R,R,R,;
