R,R,R,R,R,R,R,R,R,R,R,R,R,R,;
R, ,G,F, , , , , ,G,O, , ,R,;
R, , ,S, , , ,S, , , , , ,R,;
R, , , , , ,O, , , , , , ,R,;
R, , , , , , , , , ,G, , ,R,;
R, , , , , , , , , ,G, , ,R,;
R, , , ,S, , , ,O, , , , ,R,;
R, , , ,O, , ,O, , , , ,S,R,;
R, , ,F, , , , , ,S, , , ,R,;
R, , , , , ,S,F, , ,G, , ,R,;
R, ,C, , , , , , ,G, , , ,R,;
R, , , , , ,F,F, , , , , ,R,;
R,R,R,R,R,R,R,R,R,R,R,R,R,R,;
