R,R,R,R,R,R,R,R,R,R,R,;
R, , , , , , , , ,G,R,;
R, , ,S,S, , , , , ,R,;
R, , , , , , , , ,O,R,;
R, , , ,G, , , , , ,R,;
R, , , ,C, , ,G, , ,R,;
R, ,O, , , , ,g, , ,R,;
R, , , , , , , , ,S,R,;
R, , , , , , , , ,F,R,;
R,F, , , , ,S, , , ,R,;
R, , ,G, , , , , , ,R,;
R,t, ,F, , , , , , ,R,;
R,R,R,R,R,R,R,R,R,R,R,;
