R,R,R,R,R,R,R,R,R,R,R,;
R,t, , , , , , , , ,R,;
R, , , , , , , , ,W,R,;
R, , , ,g, , , , , ,R,;
R, , , , , ,S,G, , ,R,;
R, ,W,F, , , , , , ,R,;
R, , , ,W, , , , ,t,R,;
R, , ,G, , , , , , ,R,;
R, , , , , , , , ,g,R,;
R, , , , , , , , ,g,R,;
R, , , , , , , ,C, ,R,;
R, , , ,t, , , , ,F,R,;
R, , ,S, , , , , , ,R,;
R,R,R,R,R,R,R,R,R,R,R,;
