level,5;|R,R,R,R,R,R,R,R,R,R,R,;
R,g,g,g,d,67,g,g,g,g,R,;
R,g,g,d,g,d,g,g,g,g,R,;
R,g,g,d,d,d,67,g,g,g,R,;
R,g,d,X,g,g,g,g,g,g,R,;
R,g,g,d,g,g,g,g,g,g,R,;
R,g,g,g,d,g,g,g,g,g,R,;
R,g,g,g,d,g,g,g,g,g,R,;
R,g,g,g,g,d,g,g,g,g,R,;
R,g,g,g,g,68,68,g,g,g,R,;
R,g,g,g,g,g,g,g,g,g,R,;
R,g,g,g,g,g,g,g,g,g,R,;
R,R,R,R,R,R,R,R,R,R,R,;
