R,R,R,R,R,R,R,R,R,R,R,;
R, , , , , ,C, , ,G,R,;
R, , ,S,S, , , , , ,R,;
R, , , , , , , , ,O,R,;
R, , , ,G, , , , , ,R,;
R, , , , , , ,G, , ,R,;
R, ,O, , , , ,S, , ,R,;
R,F, , , , , , , ,S,R,;
R, , , , , , , , ,S,R,;
R,F, , , , ,S, , , ,R,;
R, , ,G, , , , , , ,R,;
R,F, ,F, , , , , , ,R,;
R,R,R,R,R,R,R,R,R,R,R,;
