level,5;|R,R,R,R,R,R,R,R,R,R,R,R,;
R,g,g,g,83,g,g,g,g,g,g,R,;
R,g,g,g,d,g,g,g,g,g,g,R,;
R,g,g,g,d,g,g,g,g,g,g,R,;
R,g,80,g,d,g,g,g,g,g,g,R,;
R,g,g,d,d,d,d,d,g,83,g,R,;
R,g,d,g,d,g,g,g,d,g,g,R,;
R,g,d,d,g,g,g,g,g,g,g,R,;
R,g,d,X,d,g,g,g,g,g,g,R,;
R,g,g,g,g,g,g,g,g,g,g,R,;
R,g,g,g,g,g,g,g,g,g,g,R,;
R,g,g,g,g,g,g,g,g,g,g,R,;
R,R,R,R,R,R,R,R,R,R,R,R,;
