level,6;|R,R,R,R,R,R,R,R,R,R,R,;
R,g,85,g,85,g,85,g,g,g,R,;
R,g,d,g,d,d,g,g,g,g,R,;
R,g,g,d,d,g,g,g,g,g,R,;
R,g,g,d,g,d,84,g,g,g,R,;
R,g,d,d,d,g,g,g,g,g,R,;
R,g,d,g,g,g,g,g,g,g,R,;
R,d,X,d,d,g,g,85,g,g,R,;
R,g,d,g,g,d,d,g,g,g,R,;
R,g,g,g,g,g,g,g,g,g,R,;
R,g,g,g,g,g,d,g,g,g,R,;
R,g,g,g,g,g,g,g,g,g,R,;
R,R,R,R,R,R,R,R,R,R,R,;
