R,R,R,R,R,R,R,R,R,R,R,;
R, , , , , , ,G, , ,R,;
R, , ,t, , , , , , ,R,;
R, , ,S, , , , , ,G,R,;
R,C, ,G, , , , , , ,R,;
R, , , ,G, , ,S, , ,R,;
R, , , , , , , , ,g,R,;
R,t, , , ,W, , , , ,R,;
R, , , , , , , , , ,R,;
R, , , , , , , , , ,R,;
R, , , , , , , , , ,R,;
R, , ,F, , , , , ,S,R,;
R, , , , , , , , , ,R,;
R,F, , , , ,S, , , ,R,;
R, ,O, , , , , , ,F,R,;
R, , , ,S, , , , , ,R,;
R,R,R,R,R,R,R,R,R,R,R,;
