level,2;|R,R,R,R,R,R,R,R,R,R,R,;
R,g,g,d,d,41,g,g,g,g,R,;
R,d,X,g,g,g,g,g,g,g,R,;
R,d,g,g,g,g,g,g,g,g,R,;
R,g,d,g,g,g,g,g,g,g,R,;
R,g,g,d,g,g,g,g,g,g,R,;
R,g,g,d,g,g,g,g,g,g,R,;
R,g,g,d,g,g,g,g,g,g,R,;
R,g,g,43,g,g,g,g,g,g,R,;
R,g,g,d,g,g,g,g,g,g,R,;
R,d,d,g,g,g,g,g,g,g,R,;
R,g,g,g,g,g,g,g,g,g,R,;
R,R,R,R,R,R,R,R,R,R,R,;
