R,R,R,R,R,R,R,R,R,R,R,;
R, , , , , , , , ,t,R,;
R, , ,g,g, , , , , ,R,;
R, , , , , , , , ,W,R,;
R, , , ,t, , , , , ,R,;
R, , , , , , ,t, , ,R,;
R, ,W, , ,C, ,g, , ,R,;
R, , , , , , , , ,g,R,;
R, , , , , , , , ,g,R,;
R,t, , , , ,g, , , ,R,;
R, , ,t, , , , , , ,R,;
R,t, ,t, , , , , , ,R,;
R,R,R,R,R,R,R,R,R,R,R,;
