level,4;|R,R,R,R,R,R,R,R,R,R,R,;
R,g,g,g,g,g,g,g,g,g,R,;
R,g,g,g,g,g,g,g,g,g,R,;
R,g,g,g,g,64,g,g,g,g,R,;
R,g,g,g,g,d,g,g,g,g,R,;
R,d,d,d,d,g,g,g,g,g,R,;
R,g,d,X,g,g,g,g,g,g,R,;
R,g,g,g,g,g,g,g,g,g,R,;
R,g,g,g,g,g,g,g,g,g,R,;
R,g,g,g,g,g,g,g,g,g,R,;
R,g,g,g,g,g,d,g,g,g,R,;
R,g,g,g,g,g,g,g,g,g,R,;
R,R,R,R,R,R,R,R,R,R,R,;
