level,3;|R,R,R,R,R,R,R,R,R,R,R,;
R,g,g,g,g,g,g,g,d,g,R,;
R,g,g,g,g,g,g,54,g,g,R,;
R,g,g,g,g,g,d,g,g,g,R,;
R,g,52,g,g,d,g,g,g,g,R,;
R,g,d,g,d,g,g,g,g,g,R,;
R,g,d,d,g,g,g,g,g,g,R,;
R,d,d,d,d,g,d,54,g,g,R,;
R,d,X,g,g,d,g,g,g,g,R,;
R,g,g,g,g,g,g,g,g,g,R,;
R,g,g,g,g,g,d,g,d,g,R,;
R,g,g,g,g,g,g,g,g,g,R,;
R,R,R,R,R,R,R,R,R,R,R,;
