level,5;|R,R,R,R,R,R,R,R,R,R,R,;
R,g,g,g,g,g,g,g,g,g,R,;
R,g,g,g,g,g,g,g,g,g,R,;
R,g,g,g,g,g,g,g,g,g,R,;
R,g,g,g,g,g,g,g,g,g,R,;
R,78,g,g,g,g,g,g,g,g,R,;
R,d,g,g,g,g,g,g,g,g,R,;
R,d,g,g,g,g,g,g,g,g,R,;
R,X,g,g,g,g,g,g,g,g,R,;
R,d,g,g,g,g,g,g,g,g,R,;
R,g,g,g,g,g,g,g,g,g,R,;
R,g,g,g,g,g,g,g,g,g,R,;
R,R,R,R,R,R,R,R,R,R,R,;
