R,R,R,R,R,R,R,R,R,R,R,;
R, , , , , , , , ,t,R,;
R, , ,S,g, , , , , ,R,;
R,C, , , , , , , ,W,R,;
R, , , ,t, , , , , ,R,;
R, , , , , , ,G, , ,R,;
R, ,W, , , , ,g, , ,R,;
R, , , , , , , , ,g,R,;
R, , , , , , , , ,g,R,;
R,t, , , , ,S, , , ,R,;
R, , ,G, , , , , , ,R,;
R,t, ,F, , , , , , ,R,;
R,R,R,R,R,R,R,R,R,R,R,;
