R,R,R,R,R,R,R,R,R,R,R,;
R, , , , , , , , ,G,R,;
R, , ,S,g, , , , , ,R,;
R, , , , , , , , ,O,R,;
R, , , ,t, , , , , ,R,;
R, , ,C, , , ,G, , ,R,;
R, ,W, , , , ,g, , ,R,;
R, , , , , , , , ,g,R,;
R, , , , , , , , ,F,R,;
R, , , , , ,S, , , ,R,;
R, , ,G, , , , , , ,R,;
R,t, ,F, , , , , , ,R,;
R,R,R,R,R,R,R,R,R,R,R,;
