 , , , ,C, , , , , ,;
 , , , , , , , , , ,;
 , ,F, , , , , , , ,;
 , , , , , , , , , ,;
 , , , , , , , , , ,;
 ,G, , , , , , , , ,;
 , , , , , , , , , ,;
 , , , , , , , , , ,;
 , , , , , , , , , ,;
 ,O, , , , , , , , ,;
 , , , , , ,O, , , ,;
O, , , , , , , , , ,;
 , , , , , , , , , ,;
