level,6;|R,R,R,R,R,R,R,R,R,R,R,;
R,g,g,g,d,g,g,g,g,g,R,;
R,g,g,g,d,g,g,g,g,g,R,;
R,g,g,d,d,g,g,g,g,g,R,;
R,g,g,g,g,d,X,d,d,g,R,;
R,g,g,g,d,d,d,g,g,g,R,;
R,g,g,g,g,g,d,g,g,g,R,;
R,g,g,g,g,g,g,d,g,g,R,;
R,g,g,g,g,g,d,g,g,g,R,;
R,g,g,g,g,g,82,g,g,g,R,;
R,g,g,g,g,g,g,g,g,g,R,;
R,g,g,g,g,g,g,g,g,g,R,;
R,R,R,R,R,R,R,R,R,R,R,;
