level,4;|R,R,R,R,R,R,R,R,R,R,R,;
R,g,g,g,62,g,g,63,g,g,R,;
R,g,g,g,d,g,g,62,g,g,R,;
R,g,g,g,d,g,d,g,g,g,R,;
R,g,d,d,X,d,d,g,g,g,R,;
R,g,d,d,g,g,g,g,g,g,R,;
R,g,g,g,g,g,g,g,g,g,R,;
R,g,g,g,g,g,g,g,g,g,R,;
R,g,g,g,g,g,g,g,g,g,R,;
R,g,g,g,g,g,g,g,g,g,R,;
R,g,g,g,g,g,g,d,g,g,R,;
R,g,g,g,g,g,g,g,g,g,R,;
R,R,R,R,R,R,R,R,R,R,R,;
