R,R,R,R,R,R,R,R,R,R,R,R,;
R,F, , , , , , ,O,G,O,R,;
R, , , , ,S, , , , , ,R,;
R, ,O, , ,C, , , , , ,R,;
R, , , , , , , , , ,G,R,;
R, , , ,G, , , , , , ,R,;
R, ,O, , , , , ,S, , ,R,;
R, , , , , , , , ,O,F,R,;
R, , , , ,S, , , , , ,R,;
R, , , , , , ,F, , ,S,R,;
R, , , , , , , , ,G, ,R,;
R, , ,F,F, , , , , , ,R,;
R,R,R,R,R,R,R,R,R,R,R,R,;
