R,R,R,R,R,R,R,R,R,R,R,;
R, , , , , , ,S, , ,R,;
R, , , , , ,C, , , ,R,;
R, ,G, , , , , , , ,R,;
R,O, , , , , , , ,S,R,;
R, ,O,F,G,O, , , , ,R,;
R,O, , , , , ,S, , ,R,;
R, , , , , , , , ,F,R,;
R, , , ,O, , , , , ,R,;
R,G, ,G, , , , , , ,R,;
R, , , , , , ,G, , ,R,;
R, , , ,S, , , , ,S,R,;
R, , ,S, , ,S, , , ,R,;
R,F, , , , , , , , ,R,;
R,F, , , , , , , ,G,R,;
R,R,R,R,R,R,R,R,R,R,R,;
