level,1;|R,R,R,R,R,R,R,R,R,R,R,R,R,;
R,g,g,g,g,g,g,g,g,d,g,g,R,;
R,g,g,g,g,g,g,g,g,g,g,g,R,;
R,g,g,g,g,g,g,d,g,g,g,g,R,;
R,g,g,g,g,g,g,g,g,g,g,g,R,;
R,g,g,g,g,g,d,g,g,g,g,g,R,;
R,d,g,g,g,g,g,g,g,g,g,g,R,;
R,g,g,g,g,g,g,g,g,g,g,g,R,;
R,g,g,g,d,g,d,g,g,g,g,g,R,;
R,g,g,g,g,g,g,g,g,g,g,g,R,;
R,g,g,d,X,d,d,d,29,g,g,g,R,;
R,g,g,g,g,g,g,g,g,g,g,g,R,;
R,R,R,R,R,R,R,R,R,R,R,R,R,;
