R,R,R,R,R,R,R,R,R,R,R,R,;
R,t, , , , , , , ,G, ,R,;
R, , , , ,S,C, , , , ,R,;
R, ,O, , , , , , , , ,R,;
R, , , , , , , , , ,G,R,;
R, , , ,G, , , , , , ,R,;
R, ,O, , , , , ,S, , ,R,;
R, , , , , , , , ,W,S,R,;
R, , , , ,S, , , , , ,R,;
R, , , , , , ,F, , ,S,R,;
R, , , , , , , , ,G, ,R,;
R, , ,F,F, , , , , , ,R,;
R,R,R,R,R,R,R,R,R,R,R,R,;
