level,4;|R,R,R,R,R,R,R,R,R,R,R,R,R,;
R,g,g,g,d,X,d,g,g,g,g,g,R,;
R,g,g,d,d,g,g,d,g,g,g,g,R,;
R,g,g,d,g,d,g,g,d,g,g,g,R,;
R,g,d,g,g,d,g,g,64,g,g,g,R,;
R,g,d,g,g,g,d,g,g,d,g,g,R,;
R,g,d,g,g,g,g,d,g,g,g,g,R,;
R,g,65,g,g,g,g,g,d,66,g,g,R,;
R,g,g,d,g,g,g,g,g,g,g,g,R,;
R,g,g,g,g,g,g,g,g,g,g,g,R,;
R,g,g,g,g,g,g,d,g,g,g,g,R,;
R,g,g,g,g,g,g,g,g,g,g,g,R,;
R,R,R,R,R,R,R,R,R,R,R,R,R,;
