level,2;|R,R,R,R,R,R,R,R,R,R,R,;
R,g,35,g,g,g,g,g,g,g,R,;
R,g,d,34,g,g,g,g,g,g,R,;
R,g,d,d,g,g,g,g,g,g,R,;
R,g,d,32,g,g,g,g,g,g,R,;
R,g,d,d,g,g,g,g,g,g,R,;
R,g,d,d,g,g,g,g,g,g,R,;
R,g,g,d,d,g,g,d,g,g,R,;
R,g,g,g,d,g,d,g,g,g,R,;
R,g,g,g,g,d,X,g,g,g,R,;
R,g,g,g,g,g,g,g,g,g,R,;
R,g,g,g,g,g,g,g,g,g,R,;
R,R,R,R,R,R,R,R,R,R,R,;
