R,R,R,R,R,R,R,R,R,R,R,R,;
R,F, , , , , , , ,G,O,R,;
R, , , , ,S, , , , , ,R,;
R, ,O, , , , , , , , ,R,;
R, , , , , , , , , ,G,R,;
R, , , ,G, , , , , , ,R,;
R, ,O, , , , , ,S, , ,R,;
R,C, , , , , , , ,O,F,R,;
R, , , , ,S, , , , , ,R,;
R, , , , , , ,F, , ,S,R,;
R, , , , , , , , ,G, ,R,;
R, , ,F,F, , , , , , ,R,;
R,R,R,R,R,R,R,R,R,R,R,R,;
