level,2;|R,R,R,R,R,R,R,R,R,R,R,;
R,g,g,g,g,d,g,g,g,g,R,;
R,g,g,g,g,g,g,g,g,g,R,;
R,g,g,g,g,g,g,g,g,g,R,;
R,g,g,g,g,g,g,g,g,g,R,;
R,g,g,g,g,g,g,g,38,g,R,;
R,g,g,g,g,g,g,g,d,g,R,;
R,g,g,g,g,g,g,g,d,g,R,;
R,g,g,g,g,g,g,g,d,g,R,;
R,40,g,d,d,d,g,d,d,g,R,;
R,40,39,d,d,d,d,d,d,g,R,;
R,40,d,d,d,d,d,d,X,g,R,;
R,g,g,g,g,g,g,g,g,g,R,;
R,R,R,R,R,R,R,R,R,R,R,;
