level,2;|R,R,R,R,R,R,R,R,R,R,R,;
R,g,g,g,g,g,g,g,g,g,R,;
R,g,g,g,g,g,g,g,g,g,R,;
R,g,g,g,g,g,g,g,g,g,R,;
R,g,g,38,g,d,d,d,41,g,R,;
R,g,g,d,d,g,g,g,g,g,R,;
R,g,g,d,d,d,d,40,g,g,R,;
R,X,d,d,d,g,d,d,41,g,R,;
R,d,d,g,g,d,g,g,g,g,R,;
R,g,g,g,g,g,g,g,g,g,R,;
R,g,g,g,g,g,g,d,g,g,R,;
R,g,g,g,g,g,g,g,g,g,R,;
R,R,R,R,R,R,R,R,R,R,R,;
