level,4;|R,R,R,R,R,R,R,R,R,R,R,;
R,g,g,g,g,g,g,g,g,g,R,;
R,g,g,g,g,g,g,g,g,g,R,;
R,g,g,g,d,g,d,X,g,g,R,;
R,g,g,g,g,d,g,d,d,g,R,;
R,g,g,d,d,g,g,d,d,g,R,;
R,g,d,g,g,d,g,d,d,g,R,;
R,d,g,g,g,d,g,56,d,g,R,;
R,d,g,g,d,g,g,g,57,g,R,;
R,59,g,d,g,g,g,g,g,g,R,;
R,g,g,59,g,g,g,g,g,g,R,;
R,g,g,g,g,g,g,g,g,g,R,;
R,g,g,g,g,g,g,g,g,g,R,;
R,R,R,R,R,R,R,R,R,R,R,;
